abandon	fear	0
ability	joy	0
able	joy	0
above	positive	0
abroad	fear	0
absence	negative	0
absent	negative	0
absolute	trust	0
abstract	anger	0
abuse	anger	0
abusive	anger	0
academic	disgust	0
accede	surprise	0
accept	positive	0
acceptable	positive	0
acceptance	joy	0
access	joy	0
accident	fear	0
accolade	negative	0
accompany	positive	0
accomplish	positive	0
accord	trust	0
account	trust	0
accountant	trust	0
accurate	trust	0
accuse	negative	0
ache	sadness	0
baby	joy	0
back	fear	0
backboard	surprise	0
background	surprise	0
backhand	positive	0
backup	positive	0
backward	trust	0
bacterium	fear	0
bad	sadness	0
badly	sadness	0
bag	trust	0
baggage	trust	0
bake	joy	0
balance	surprise	0
balance	surprise	0
ball	positive	0
band	fear	0
bandage	fear	0
bane	positive	0
bang	positive	0
bank	disgust		0
banker	negative	0
bankrupt	fear	0
bankrupt	fear	0
bankruptcy	fear	0
banter	joy	0
bar	joy	0
barber	surprise	0
bare	disgust	0
cage	fear	0
cake	positive	0
calculate	trust	0
calculation	trust	0
calendar	surprise	0
calf	positive	0
call	surprise	0
call	surprise	0
callous	surprise	0
calm	joy	0
camera	anticipation	0
camp	surprise	0
camp	surprise	0
campaign	anticipation	0
campus	negative	0
can	positive	0
can	positive	0
cancel	negative	0
cancer	fear	0
candid	joy	0
candidate	surprise	0
candy	positive	0
cap	positive	0
capable	positive	0
word	emotion	0
capacity	positive	0
capital	surprise	0
capital	surprise	0
captain	trust	0
capture	trust	0
car	fear	0
dad	joy	0
daily	anticipation	0
daily	anticipation	0
dam	anger	0
damage	anger	0
damage	anger	0
damages	anger	0
damp	negative	0
dance	joy	0
dance	joy	0
danger	anger	0
dangerous	anger	0
dare	trust	0
dare	trust	0
dark	fear	0
dark	fear	0
data	postive	0
date	postive	0
date	anticipation	0
daughter	joy	0
dawn	positive	0
day	anticipation	0
dead	negative	0
deaf	negative	0
deal	trust	0
deal	trust	0
deal	trust	0
dear	joy	0
dearth	negative	0